1222222222211111
1d         t   3
1          1   3
1          1 p 3
1t11111111111111
1   1 x v n   a1
1   1         s1
1   t         d1
1  z1         f1
1  c1         g1
1  b1         h1
1   1         j1
1   1          1
1   1          1
1   1e        w1
1111144444444441