1222222222211111
1     v    t   3
1          1   3
1          1aea3
1t11111111111111
1  e1 x v n   a1
1   1         s1
1   t         d1
1   1         f1
1   1         g1
1   1         h1
1   1         j1
1   1          1
1   1 e        1
1   1          1
1111144444444441