1111111111777777
1     1 e 7&7 aa
1   1 1   7 7 77
1 !@1   x       
1!111t11117 7  e
1a1       7 7   
1a1 11111 7 7777
1a1  f1   7    s
1a1   1 c 7 7 tf
1   ^e1   7 7   
5555555 555555#5
5t      5   5 aa
555 5 555 555 55
5s  5       5   
5 e 5 f 5 n 5   
5 t^5 $*5     e 