3333333333888888
3 3*$^3j  8g8sf 
3 3 et333 8a8   
3         8t    
3 3333333 88888 
3    z3!       c
3 3aea3!e 8 8 e 
3 3aha3t  8 8  t
3 333333338 8888
3  s3a3f f8 8^&!
3  f3a3   8 8  !
3^ t3     8     
333 333 33888n88
3     3   8d8  @
3 e 3 3 e 8 8 e@
3t ^3     8     