3333333333333333
3 2 e^2a2 e 5&g#
3 2 t 2a2   5  !
3     2     5 $*
3^2 22222 225 55
3h2     2   5   
3a222 2 222 5   
3a2   2        z
3a2se 2 2 e 5 55
3    v2 2 t 5   
377777777 775  b
3ff aa7    f5   
377 77777 77555 
3     e 7  ^5   
3 7 t 7 7 t 5   
3j7 s 7    #5e  