8888888822222222
8    s#&2     $*
888 888x2 2n2  $
8    e8   2&2saf
8 8!!82 22222222
8 8 fg8 2t ^2  a
8 8   8 2 e 2 ja
8     8        a
888 888 222 2222
8h8     2     a 
8 8 t 8 2 e 2 f 
8     8 2   2 at
55555 555555555!
5t d5   5 e 5a  
5 e 5 s 5 5 5   
5     ^   5   e 