4444444422222222
4  t4 j 2      t
4   4 e 2 2 2 e 
4  ^4     2 2   
4 44444 222 2@22
4   4   2   2h  
4 f 4 222 22222v
4 z    t2       
444 8 s 2 e%2   
4   8   2#f*2^e 
4 f 888 88888888
4   8   8a8   fd
444 8 888a8 8888
4   !  &8a8 8   
4 s 8 b 8 8 8   
4te 8          e