33333333333333333333333333333333
3   #aa 3       3a3           t&
3 33333 333e3 333a3 33333 333 33
3       3s  3   3a3   3     3aa%
3   3   3f  3 v 3e3 z 3 3 e 3aa*
3 t 3^  e   3         3j3#t^3aa%
3@@@33334444444444444 4444444444
3     t!! 4 4   4         4a4h  
333 33334 4 4 444 44444 444a444 
3      g4 4     4     4   4a4   
3t3333334 4 4 e 4 4 e 4 s 4a4 f 
3   3j  4   4   4 4   4         
333 333 44444 444 444444444 4444
3       4 4     4 4       4    g
3 c 3 e 4 444 444 4 44444 4 4@@@
3   3aaa4 4 4   4     4a  4 4  #
3 3333334 4 4 e 4 4 z 4a! 4 4   
3  ^3           4 4   4ast4    ^
3   3 e 444 4444444 444444444 44
3       4   4  d4        s4     
333 33334 444 444 44444 444 4 e 
3       4             4   4h4   
3 s 3 f 4   4   4 4   4   444 44
3   3   4&  4s f4 4 e 4aaa4t4   
88888888888 888888888888884 4 e 
8j  t&8   8    h8     8   4     
888 888 e 8t88888a8 f 8 e 4#444 
8         8     8a8   8   4a4   
8 8888888 88888 88888 8 884a444 
8t8^$#8               8   4a4n  
8 8 e 8 e 8a8 t 8 8 e 8 b 4a4   
8    #8   8a8$*$8 8       4     