111111111222222222222222
1 1s1f  1       2   2  j
1 1 111 1 2t2 e 2 2 2 22
1 1     1 2&2f s2 2     
1 1 1 c 1 2222222 2 2 e 
1   1   1       2 2 2   
11111 111 e 2 z 222 2222
1aa   t!1   2   2&2    s
111 111112222 222t2 2 e 
1a  1$ ^1       2   2  f
1   1*e 1 c 2 e 222 2222
1a  1$  1   2     2 2 ag
111 111 1 2222222 2 2 22
1       1 2     2   2   
1@  1   1 2 2   2 2 2 t 
1!  1   1   2   2 2     
111 11115!!!555 55555555
1       5!# 5     5     
1 t 1 z 5   5a5   5 5 b 
1   1       5d5     5   
111 1111555 55555 555e55
1^     #5   5a5   5     
1   1   5%  5a5 e 5a5   
1se 1hef5*        5a5   