777777777777774444444444
7  ^7&7   7%*%4     4  g
7   7t7 e 7 t 4 4 444 44
7             4 4      a
777 777 77777 4 4 e 4 sa
7   7&7  #7#  4 4   4 ta
7   @ 7   7  c4 444444!4
7fsf@    ^7   4 4   4   
77777777777 774 4 e 4   
7h  aa7 !             n 
777 777 777 77444444444 
7  t      7   4         
77777 7 7 777 4 444 4444
7     7 7     4   4     
7 7 e 7 7 7 e 4 j 4 4 t 
7 7$*$7 7 7f f4aaa4 4   
2222222 2222222222222222
2s    2   2         2   
2!2 222  z2 s 22222 2   
2d2    t      2 2       
2a222 222 2 222 2 222 22
2a2   2   2  f2e    2   
2a2 e 2 e 2  s2 2   2 eb
2     2   2  f2 2   2   