111111111111111111111111
1     1   1 t ! aaaa1ja 
11111 111 1 111 1111111 
1 1   1         1       
1 1   1 e 1 c 1 1 s 1 e 
1    ^1   1   1    t1   
666 6663333 333333333333
6h6          s3   3 3   
6a6   6 z 3 e 333 3 3 e 
6     6 t^3  f3#        
66666 6 3333333 t 333 33
6gaaa 6           3!3  t
66666 633 333 3 333 3 33
6     6f  3   3  f3     
6t6 e 6s  3 e 3 c 3 3   
6&6   6f  3   3   3&3   
66666 633333333 33333 33
6     6   3t3&3  %3     
6t6 s 6 e 3 3 3  *3 3  b
6&6   6          %3 3   
66666 633 33333333333 33
6a6   6   3afa3   3     
6a6 e 6 b 3aea3   3 3e  
6     6           3d3   
